17 12
11 11 11 11 11 11 11 11 11 11 11 11 11 11 11 11 11
32 33 32 33 32 33 32 33 38 39 32 33 32 33 32 33 32
33 33 31 31 33 33 31 33 38 39 32 32 30 33 32 32 30
15 15 15 15 15 15 15 15 38 39 15 15 15 15 15 15 15
40 1 0 34 0 35 0 1 38 39 0 0 0 1 0 1 0
2 3 2 3 2 3 2 3 38 39 2 3 2 3 0 34 0
4 5 0 0 0 1 4 5 38 39 0 1 0 1 0 4 5
2 3 2 3 24 25 26 2 38 39 2 3 2 3 2 3 2
0 1 0 23 27 28 29 1 0 34 2 3 2 3 2 3 2
44 45 2 2 2 3 2 3 2 3 2 3 2 3 2 3 2
8 8 8 8 8 8 8 8 8 8 8 8 8 8 8 8 8
16 16 16 16 16 16 16 16 16 16 16 16 16 16 16 16 16