17 12
32 33 32 33 32 33 32 33 38 39 32 33 32 33 32 33 32
15 15 15 15 15 15 15 15 15 15 15 15 15 15 15 15 15
34 35 1 34 0 0 35 0 1 35 0 0 1 1 34 0 1
0 1 4 5 1 34 0 35 35 0 1 35 0 0 1 1 34 
40 1 34 35 1 34 0 0 35 0 1 35 0 0 4 5 34 
0 1 34 0 0 35 0 1 35 0 0 1 1 34 35 1 34
0 1 34 35 1 34 0 0 35 4 5 35 0 0 1 1 34 
0 1 0 35 24 25 26 1 0 1 1 34 34 35 1 34 0
1 34 0 0 27 28 29 35 0 0 1 1 34 0 1 34 35
0 1 34 35 1 34 0 0 35 0 1 35 0 0 1 1 34 
8 8 8 8 8 8 8 8 8 8 8 8 8 8 8 8 8
16 16 16 16 16 16 16 16 16 16 16 16 16 16 16 16 16